  XXXXXX
  X ..@X
  X ** X
  XX XXX
   X X  
   X X  
XXXX X  
X    XX 
X X   X 
X   X X 
XXX   X 
  XXXXX 
