  XXX    
XXX  XXXX
X     * X
X X  X* X
X . .X@ X
XXXXXXXXX
